111111111111111
1P1000000000001
101010111111101
100010000000101
101111111011101
1011111C0010001
1C1000011010111
111011011010001
1E00110000100C1
111111111111111
