11111111111111111111111111111111111
1000000000000000000P000000000000001
10000000000000000000000000000000001
10000000000000000000000000000000001
10000000000000000000000000000000001
100000000000000000000000000000C0001
10000000000000000000000000000000001
1000C0000000000E0000000000000000001
10000000000000000000000000000000001
10000000000000000000000000000000001
10000000000000000000000000000000001
100000000000000000000000000C0000001
11111111111111111111111111111111111
