1111111111111
1P00000000001
1111111111101
1000000000001
1011111111111
100000C000001
10C000000C001
100000C000001
1111111111101
1E00000000001
1111111111111
