11111
1P001
100011111
10CI1
10001
100E1
11111
