1111
10P1
1001
1C01
10E1
1111
